#***###########
#*************#
#*************#
#*************#
#*************#
#*************#
#*************#
#*************#
#*************#
#*************#
#*************#
#*************#
#*************#
#*************#
#*************#
#*************#
#*************#
#*************#
#*************#
###########***#